NO ./map/texture/gam_north.xpm
SO ./map/texture/lee_south.xpm
WE ./map/texture/gon_west.xpm
EA ./map/texture/gun_east.xpm

F 220,100,0
C 225,30,0

        1111111111111111111111111
        10000000001100000110000001
        1011000001110000011000001
        1001000000000000000000001
111111111011000001110000000000001
100000000011000001110111101111111
11110111111111011100000000001
11110111111111010101000000001
11000000110101011100000000001
1000000000000000000000E000001
10000000000000001101000010001
1100000111010101111101111000111
11110111 1110101 101111010001
11111111 1111111 111111111111